6 6 123 1 15 21 
1 2 3 1 3 4
3 4 1 2 1 4
1 1 2 1 3 2 
3 1 4 2 1 2
2 3 1 1 3 1
3 1 2 1 3 4