6 6 13 7 20 18
1 3 2 1 2 3
3 1 1 3 3 1
7 3 5 2 5 7
7 7 2 1 7 7
7 7 7 7 7 7
7 7 7 7 7 7